1M11111M1
M0000000M
100010001
100010001
101111101
100010001
10N010001
M0000000M
1M11111M1
