WE assets/gradient.png
EA assets/highres.png
NO assets/cub3d_test.png
SO assets/checkerboard.png
C 255,6,181
F 255,181,6
D assets/edgetest.png
SP assets/blahaj/ 15

1M111111111111111M1
M00000000000000000M
1000100000000010001
100X10000D000010001
1011100000000011101
1000000000000000001
100000000N000000001
1000000000000000001
1000000000000000001
1011100000X00011101
1000100000000010001
1000100000000010001
M00000000000000000M
1M111111111111111M1
