   111
1111M11111
1000010001
1001M10001
1000010001
1000000001
1000111001
10000M0001
10N0010001
1000000001
1111111111
