1M111111111111111M1
M00000000000000000M
1000100000000010001
1000100000000010001
1011100000000011101
1000000000000000001
100000000N000000001
1000000000000000001
1000000000000000001
1011100000000011101
1000100000000010001
1000100000000010001
M00000000000000000M
1M111111111111111M1
