  111M111M1111
0 10D0000000001
  1100000000001
  110000000W001
  1100000000001
10 1X0000000011
111111111111111
