1111111111111111111111
10010000000B0000000C01
1000000000000000000001
10000C0000000000B00001
1000000000000000000001
1000000001110000000001
1000000001C11100000001
10000000010B0000000001
1000000001111100000001
1000000000000000000001
100000C000000011101001
1P1000000000011E000001
1111111111111111111111
