  111M111M1111
0 10D0000000001
  1100000000001
  11X000000W001
  1100000000001
10 1X00X0000X11
111111111111111
