  1111111
0 10000011
  11000001
10 1000S11
1111111111
