1111111111111111111111111
1000000000000000000000001  1   1
1000000000000000000000001  1   1
1000000000000000000000001  11111
1000000000000000000000001  1   1
1000000000000000000000001  1   1
10000000000N0000000000001
1000000000000000000000001  11111
1000000000000000000000001    1
1000000000000000000000001    1
1000000000000000000000001    1
1000000000000000000000001  11111
1000000000000000000000001
1111111111111111111111111
